W W W W W W W W W W W W W
W - - - - - - - - - - - W
W - - - - - - - - - - - W
W - - - - - - - - - B - W
W - - - - - - - - - - - W
W - - - - - W W W - - - W
W - - - - - - - - - - - W
W - - - - - - S - - P - W
W - - - - - - - - - - - W
W W W W W W W W W W W W W